Account No,DATE,TRANSACTION DETAILS,VALUE DATE,WITHDRAWAL AMT,DEPOSIT AMT,BALANCE AMT
123456,2025-10-01,ATM Withdrawal,2025-10-01,500,0,49500
123456,2025-10-02,POS Purchase,2025-10-02,200,0,49300
123456,2025-10-03,Online Transfer,2025-10-03,15000,0,34300
123456,2025-10-04,Salary Deposit,2025-10-04,0,2500,36800
789012,2025-10-01,ATM Withdrawal,2025-10-01,12000,0,48000
789012,2025-10-05,Online Purchase,2025-10-05,300,0,47700
789012,2025-10-06,Refund Received,2025-10-06,0,500,48200
